Ambiguity - अस्ऩष्टता Deface - फदनाभ कयना
Aggravate - उत्तेजजत कयना Exhibit - प्रदर्श
Apparently - प्रत्मऺस्ऩष्ट रूऩ Enormous - बायी
Auspicious - र्ुब Enthusiastic - उत्साही
Autumn -र्यद Effeminate - स्रीवत
Appendix - ऩरयशर्ष्ट Enmity - र्रुता
Aggregate - ऩूर्शमोग Essential - आवश्मक
Abominable -घघनौना Endeavour - प्रमास कयना
Accomplish - ऩूया Etiquette - शर्ष्टाचाय
Admonish -चेतावनी देना Elaborated - सववस्ताय
Amusement -भनोयंजन Futile - व्मर्श
Antagonism - ववयोध Fragile - नाजुक
Ancestor - ऩूवजश Ferocious - क्रूय
Adjourn - स्र्गगत कयना Forfeit - अर्शदंड
Adroit - घनऩुर् Furious - अघत क्रुद्ध
Amiable - सफ का प्माया Fatal - घातक
Affliction - कष्ट Generosity - उदायता
Bias - ऩूवाशग्रह Grievous - कष्टदामक
Benevolent - उदाय Gaudy - बड़कीरा
Blandish - चाऩरूसी Gnaw - कुतयना
Bewilder - घफया देना Grandeur - वैबव
Barricade - फाधा Humorous - ववनोदऩूर्श
Chaos - अव्मवस्र्ा Haphazard - अव्मवजस्र्त
Catastrophe - तफाही Hymn - स्तोर
Courteous - ववनम्र Insincere - घनष्ठाहीन
Conceit - कष्टकल्ऩना Illuminate -उजागय कयना
Condemn - घन ंदा कयना Impulsive - आवेगी
Curiosity - जजऻासा Jumpy - गचड़गचड़ा
Consequence - ऩरयर्ाभ Jocund - प्रपुल्र
Charitable - उदाय Jester - ववदषूक
Condensed - गाढा Juvenile - ककर्ोय
Courtier - याजदयफायी Kindred - ऩरयजन
Calamity - आऩदा Kinsman - स्वजन
Clamor - कोराहर Knavish - धूती
Capacious - ववर्ार Lenient - उदाय
Demise - घनधन Melancholy - उदासी
Dauntless - घनडय Nymph - अप्सया